82x9
128x128
------
9999999999999999999999999999999999999999999999999999999999999999999999999999999999
0000000000000000000000000000000000000000000000000000000000000000000000000000000909
0000000000000000000000000000000006000000005670000000000000000006000000567000000909
0000000000000000000000056700000009000000600900000000567000000009000006999600000009
6666666666666666666666699966666666696666960006669666666666666666666666666666666609
9999999999999999999999999999999999999999999999999999999999999999999999999999999909
7000000000000000000000000000000000000000000000000000000000000000000000000000000009
7000000000000000000000000000000000000000000000000000000000000000000000000000000009
6666666666666666666666666666666666666666666666666666566666666666666666666666666609
9999999999999999999999999999999999999999999999999999999999999999999999999999999909
------
0000000000000000000000000000000000000000000000000000000000000000000000000000000000
1200000000030000000000000040000000000000500000000000000000000000000000000000000000
1200000000030000000000000040000000000000500000000000000000000000000000000000000000
1200000000030000000000000040000000000000506000000000000000000000000000000000000000
0000000000000000000000000000000000000000006600000000000000000000000000000000000000
0000000000000000000000000000000000000000000000000000000000000000000000000000000000
0000000000000000000000000000000000000000000000000000000000000000000000000000000000
0000000000000000000000000000000000000000000000000000000000000000000000000000000070
0000000000000000000000000000000000000000000000000000000000000000000000000000000070
------
player1|PLAYER|PLAYER|0x3
ninja1|NINJA|NINJA|43x4
box1|BOX|BOXx100|30x3
box2|BOX|BOXx200|79x3
spikes1|SPIKES|TRAP|17x3
spikes2|SPIKES|TRAP|19x3
saw1|SAW|TRAP|43x1
acid1|ACID|TRAP|35x4
spikes3|SPIKES|TRAP|68x3
spikes4|SPIKES|TRAP|19x3
spikes5|SPIKES|TRAP|73x2
acid2|ACID|TRAP|48x4
saw2|SAW|TRAP|53x2
spikes6|SPIKES|TRAP|58x2
------