16x8
128x128
------
9999999999999999
0000000000000000
0000000000000000
0000000000000000
c66666666600666b
9999999999600099
0000000005760000
0012300008906000
c66666666666666b
------
0000000000000000
0000000000000000
0000000011000000
0000000000000000
0000000000000000
0000000000000000
0000000000000000
0000000000000000
------
PLAYER|PLAYER|4x2
BOX|GAMEOBJECT|5x2
------
