26x9
128x128
------
99999999999999999999999999
00000000000000000000000909
00000000000060000056700909
00000000000090006009000009
66666666666666969600066609
99999999999999999999999909
00000000057600000000000009
00123000089060000000000009
66666666666666666666666609
99999999999999999999999999
------
00000000000000000000000000
00000000000000000000000000
00000000110000000000000000
00000000000000000000000000
00000000000000000000000000
00000000000000000000000000
00000000000000000000000000
00000000000000000000000000
00000000000000000000000000
------
player1|PLAYER|PLAYER|0x2
box1|BOX|GAMEOBJECT|9x2
box2|BOX|GAMEOBJECT|23x2
spikes1|SPIKES|TRAP|5x2
spikes2|SPIKES|TRAP|7x2
acid1|ACID|TRAP|14x4
saw1|SAW|TRAP|19x1
------
