65x9
128x128
------
999999999999999999999999999999999999999999999999999999999999999
000000000000000000000000000000000000000000000000000000000000909
000000000000000000000000000000000600000000567000000000600000909
000000000000000000000005670000000900000060090000000000900000009
666666666666666666666669996666666666666696000666666666666666609
999999999999999999999999999999999999999999999999999999999999909
000000000000000000000000000000000000000000000000000000000000009
000000000000000000000000000000000000000000000000000000000000009
666666666666666666666666666666666666666666666666666656666666609
999999999999999999999999999999999999999999999999999999999999999
------
000000000000000000000000000000000000000000000000000000000000000
020000000003000000000000004000000000000050000000000000000000000
020000000003000000000000004000000000000050000000000000000000000
020000000003000000000000004000000000000050000000000000000000000
000000000000000000000000000000000000000000060000000000000000000
000000000000000000000000000000000000000000000000000000000000000
000000000000000000000000000000000000000000000000000000000000000
000000000000000000000000000000000000000000000000000000000000000
000000000000000000000000000000000000000000000000000000000000000
------
player1|PLAYER|PLAYER|0x3
box1|BOX|BOXx100|31x3
box2|BOX|BOXx200|60x3
spikes1|SPIKES|TRAP|17x3
spikes2|SPIKES|TRAP|19x3
spikes3|SPIKES|TRAP|43x1
------